1 1 1 1 1 1 1 1 1 1 1 1 1 1 1 1 1 1 1 1
1 0 0 0 0 0 0 0 0 0 0 0 0 0 0 0 0 0 0 1
1 0 0 0 0 0 0 0 0 0 0 0 0 0 0 0 0 0 0 1
1 0 0 0 0 0 0 0 0 0 0 0 0 0 0 0 0 0 0 1
1 0 0 0 0 0 0 0 0 0 0 0 0 0 0 0 0 0 0 1
1 0 0 0 4 0 0 0 0 0 0 0 0 0 0 0 0 0 0 1
1 0 0 0 4 0 0 0 0 0 0 0 0 0 0 0 0 0 0 1
1 4 4 4 4 4 0 0 0 0 0 0 0 0 0 0 0 0 0 1
1 0 0 0 4 0 0 0 0 0 0 0 0 0 0 0 0 0 0 1
1 0 0 0 4 0 0 0 0 2 0 2 0 0 0 0 0 0 0 1
1 0 0 0 4 0 0 0 0 0 0 2 1 1 1 1 1 0 0 1
1 0 0 0 0 0 0 0 0 2 0 2 0 0 0 0 1 0 0 1
1 0 0 0 0 0 0 0 0 0 0 0 0 0 0 0 1 0 0 1
1 0 0 0 0 0 0 0 0 0 0 0 0 0 0 0 1 0 0 1
1 0 0 0 0 0 0 0 0 0 0 0 0 0 1 1 1 0 0 1
1 0 0 2 2 2 2 2 2 0 0 0 0 0 1 0 0 0 0 1
1 0 0 2 0 0 0 0 2 0 0 0 0 0 1 0 0 0 0 1
1 3 3 0 0 2 2 0 2 0 0 0 0 0 1 0 0 0 0 1
1 0 0 0 0 2 0 0 2 0 0 0 0 0 1 0 0 0 0 1
1 0 0 0 3 0 0 0 2 0 0 0 0 0 1 0 0 0 0 1
1 0 0 0 3 0 0 0 0 0 0 0 0 0 1 0 0 0 0 1
1 1 1 1 1 1 1 1 1 1 1 1 1 1 1 1 1 1 1 1